123helpme.com	123HelpMe
ozessay.com.au	allwriting.net
privatewriting.com	allwriting.net
essaymasters.co.uk	allwriting.net
alpharesumes.com.au	alpharesumes.com.au
australianassignmenthelp.com	Australianassignmenthelp
bluesparkresumes.com.au	Bluesparkresumes
starkessays.com	Boosta
paperell.com	Boosta
aussieassignments.net	Boosta
australianwritings.com.au	Boosta
bestessaywritinghelp.org	Boosta
aussieessayreviews.com	Boosta
essaybison.com	Boosta
paperesson.com	Boosta
au.edubirdie.com	Boosta
ca.edubirdie.com	Boosta
hulkessays.com.au	Boosta
phdify.com	Boosta
gradescout.com	Boosta
custompaperswriter.com	Boosta
paperial.com	Boosta
essaylab.com	Boosta
degreeway.com	Boosta
customwriting.com	Boosta
samedaypapers.com	Boosta
eduzaurus.com	Boosta
papersowl.com	Boosta
top5writingservices.com	Boosta
studarea.com	Boosta
canadianessayreviews.com	Boosta
britishessayservices.com	Boosta
uk.edubirdie.com	Boosta
guidessay.com	Boosta
essaysamurai.com	Boosta
cheappaperwriters.com	Boosta
craftresumes.com	Boosta
essayyoda.com	Boosta
professionaldissertation.com	Boosta
payforessays.blogspot.com	Boosta
britishessaywriter.com	Boosta
customessaywriter.org	Boosta
collegepaperz.org	Boosta
gradexy.com	Boosta
acustomessay.com	Boosta
cheapwritingservice.info	Boosta
essayvikings.com	Boosta
essayontime.com.au	Boosta
essayservicewriter.com	Boosta
easyessaywriters.org	Boosta
auessaywriters.net	Boosta
monstersessay.com	Boosta
edubirdie.com	Boosta
writingdeal.com	Boosta
uk.edusson.com	Boosta
personalessaywriter.com	Boosta
papereast.com	Boosta
studymoose.com	Boosta
essayservicewriting.org	Boosta
edusson.com	Boosta
buywrittenessays.com	Boosta
au.papersowl.com	Boosta
studenthelper.net	Boosta
ukessay.com	Boosta
us.edusson.com	Boosta
buyessayworld.com	Boosta
typemyessays.com	Boosta
paidessay.com	Boosta
livepaperhelp.info	Boosta
tutoriage.com	Boosta
writingpeak.co.uk	Boosta
essayinfo.com	Bright Minds
careersteering.com	Career steering
careerperfect.com	careerperfect.com
domain	company
craigcareerconsulting.net	Craigcareerconsulting
smart.study	Custom-writing.org
i-termpaper.com	Custom-writing.org
assignmentservices.ca	Custom-writing.org
papersasap.com	Custom-writing.org
overnightessay.com	Custom-writing.org
helpfulpapers.com	Custom-writing.org
custom-papers.co.uk	Custom-writing.org
prowriterz.com	Custom-writing.org
custom-writing.org	Custom-writing.org
aplusreports.com	Custom-writing.org
customessaymeister.com	Customessaymeister
cv-writers.org.uk	cv-writers.org.uk
cvsaviour.com.au	cvsaviour.com.au
topreview4you.com	Devellar
essayontime.co.uk	Devellar
topaussiewriters.com	Devellar
superiordissertations.com	Devellar
essayswritersland.com	Devellar
topbritishessays.com	Devellar
australianwritings.com	Devellar
ukbestbestessays.com	Devellar
needmypaper.com	Devellar
easyessayhelp.info	Devellar
aussiewriter.com	Devellar
bestessays-writer.com	Devellar
my-essay-writer.com	Devellar
careersbooster.com	Devellar
usdissertations.com	Devellar
resumesplanet.com	Devellar
essayrush.net	Devellar
bigbangdissertation.com	Devellar
essays.scholaradvisor.com	Devellar
bestessayresearch.com	Devellar
assignmentmasters.co.uk	Devellar
auresumecentre.com	Devellar
collegeessaywritingservice.blogspot.com	Devellar
ukessaysreviews.com	Devellar
bestessays-uk.org	Devellar
essayuniverse.net	Devellar
writemy-essay.biz	Devellar
rushmyessays.org	Devellar
ontimeessay.org	Devellar
bestessayservicereviews.com	Devellar
aussieessay.org	Devellar
superiorrpaperss.com	Devellar
nsw-writers.com	Devellar
asiawriters.com	Devellar
writingessayuk.com	Devellar
myessaypapers.com	Devellar
admission-service.com	Devellar
myassignmentwriting.com.au	Devellar
ninjaessays.org	Devellar
write-essay.org	Devellar
ukdissertationsonline.com	Devellar
thebestessayshelp.com	Devellar
assignmentgeek.com.au	Devellar
ukresumewriting.com	Devellar
edugeeksclub.com	Devellar
superiorpaper.org	Devellar
termpaperspro.net	Devellar
bestaustralianwritings.com	Devellar
rushmyessays.com.au	Devellar
writingserviceuk.com	Devellar
aussieessay.net	Devellar
besttermpaper.com	Devellar
aussiessay.net	Devellar
essaysontime.com.au	Devellar
auresumereviews.com	Devellar
bestbritishwriter.com	Devellar
marvelous-reviews.com	Devellar
essayheaven.org	Devellar
uk-dissertation.net	Devellar
victoria-assignment.com	Devellar
bestessay.org	Devellar
aubestsessays.com	Devellar
ok-essayontime.com	Devellar
uk-dissertation.com	Devellar
cvmonstersuk.com	Devellar
writingservice-us.com	Devellar
ukdissertationspro.com	Devellar
resumeplanets.org	Devellar
research-paper-writing-online.blogspot.com	Devellar
essaydot.com	Devellar
essaywritinglab.co.uk	Devellar
essayservices-reviews.com	Devellar
cabestessay.com	Devellar
ukessaysbestwriter.com	Devellar
rushessayonline.com	Devellar
911essaywriting.com	Devellar
bestdissertation.com	Devellar
dissertations.superiorpapers.com	Devellar
auessaypapers.com	Devellar
myassignmenthelpaustralia.blogspot.com	Devellar
bestwritingservicesreviews.com	Devellar
australianwritings.net	Devellar
greatestessay.com	Devellar
superiorpaper.net	Devellar
resumesplanet-au.com	Devellar
essaymama.org	Devellar
bestessaytips.com	Devellar
write-my-essay-for-me.com	Devellar
superioressaypapers.org	Devellar
russhessays.com	Devellar
help.plagtracker.com	Devellar
essay-services-review.com	Devellar
dissertation-writing-services-online.blogspot.com	Devellar
thebestessayservice.com	Devellar
customwritings.ws	Devellar
rushmyessays.co.uk	Devellar
college-paper-writing-service.reviews	Devellar
bestassignmentservices.co.uk	Devellar
aussieessays.org	Devellar
topqualitysessays.org	Devellar
essaywriters.net	Devellar
aussiessaywriting.com	Devellar
auresumes.com	Devellar
bestessay-services-reviews.com	Devellar
brillassignment.co.uk	Devellar
uk.bestessays.com	Devellar
rushanessay.com	Devellar
proessaywriting.com	Devellar
resumeservicesau.com	Devellar
rush-my-essay.com	Devellar
australianwritings.biz	Devellar
bestessays.com.au	Devellar
awriter.org	Devellar
college-paper.org	Devellar
dissertationserviceus.com	Devellar
essayhell.org	Devellar
topamericanwriters.com	Devellar
essay-reviews.org	Devellar
writemyessay4me.blogspot.com	Devellar
hwsolvers.com	Devellar
best-essay-writing.services	Devellar
legitimate-writing-services.blogspot.com	Devellar
rushessaya.com	Devellar
researchpapermama.com	Devellar
rushmyessay.com	Devellar
bestessays.com	Devellar
planetsresume.com	Devellar
superiorpapers-writer.com	Devellar
aubestessays.com	Devellar
assignmentmasters.org	Devellar
besstdissertation.com	Devellar
top5writingservicesreviews.com	Devellar
uk-dissertationservice.com	Devellar
superiorspaper.net	Devellar
bestessaypoint.com	Devellar
easywritingservice.com	Devellar
rushessaysbest.com	Devellar
caresumecentre.com	Devellar
ca.bestessays.com	Devellar
aussi-bestessays.com	Devellar
russhessay.net	Devellar
writemyessay-site.com	Devellar
rushessay-writer.com	Devellar
resumesplanetuk.com	Devellar
australian-writings.org	Devellar
uk.bestdissertation.com	Devellar
pay4essayonline.blogspot.com	Devellar
plagtracker.com	Devellar
ukresumes.net	Devellar
ukbesteessays.com	Devellar
getcoolessay.com	Devellar
essaycenter.biz	Devellar
college-papers.org	Devellar
australian-writings.net	Devellar
homework-desk.com	Devellar
essayontime.com	Devellar
galaxyessay.com	Devellar
usadissertationwritingservice.com	Devellar
rushmypapers.me	Devellar
bestdissertations.com	Devellar
queensland-assignment.com	Devellar
aussiewritingreviews.com	Devellar
greatessay.biz	Devellar
analyzedu.com	Devellar
essaymama.com	Devellar
besttermpapers.com	Devellar
bestdissertationassist.net	Devellar
ukessayspapers.com	Devellar
superiorpapers.com	Devellar
caresumeworld.com	Devellar
topreviewstars.com	Devellar
aussiessayservices.com	Devellar
uk.superiorpapers.com	Devellar
au-resumesplanet.com	Devellar
custom-essay-writer.net	Devellar
russhessay.com	Devellar
aussiessay.com	Devellar
thebestessayshelp.net	Devellar
eessayontime.com	Devellar
essayshop.org	Devellar
123essay.org	Devellar
bestcustomessay.org	Devellar
ukbestessay.net	Devellar
au.bestessays.com	Devellar
resume-writing-services.reviews	Devellar
planetsresume.net	Devellar
bestaustralianessays.com	Devellar
paperwritingpro.com	Devellar
wizessay.com	Devellar
rushessay.com	Devellar
top10writers.com	Devellar
essay-writing-service.reviews	Devellar
properresumes.com	Devellar
rushmyessay.biz	Devellar
my-essayontime.com	Devellar
mymathdone.com	Devellar
assignmenthelper.com.au	Devellar
a-writer.com	Devellar
australianessays.org	Devellar
nerdywriters.co.uk	Devellar
essaymission.com.au	Devellar
xpertwriters.com	Devellar
essay-one-time.com	Devellar
dissertation-service.org	Devellar
top5essaywritingservices.blogspot.com	Devellar
esssayontime.com	Devellar
ninjaessay.com	Devellar
ninjaessays.com	Devellar
essay-to-go.net	Devellar
cheapessayservice.net	Devellar
aussiewritings.com	Devellar
essaywritingland.com	Devellar
uk-essay.net	Devellar
editorworld.com	Editorworld
gwr.arizona.edu	Education
careers.uiowa.edu	Education
amazing-space.stsci.edu	Education
actx.edu	Education
grad.ucdavis.edu	Education
askus.baker.edu	Education
undergrad.stanford.edu	Education
gocanvas.stanford.edu	Education
faculty.history.wisc.edu	Education
politicsir.cass.anu.edu.au	Education
det.nsw.edu.au	Education
luc.edu	Education
iup.edu	Education
career.cornell.edu	Education
adelaide.edu.au	Education
uwap.uwa.edu.au	Education
canvas.jmu.edu	Education
ccny.cuny.edu	Education
scu.edu.au	Education
eap.ucsb.edu	Education
library.uq.edu.au	Education
csub.edu	Education
answers.library.gsu.edu	Education
pomona.edu	Education
leesasblog.global2.vic.edu.au	Education
byu.edu	Education
career.utk.edu	Education
hbswk.hbs.edu	Education
uwgb.edu	Education
arts.unimelb.edu.au	Education
gallatin.nyu.edu	Education
american.edu	Education
lsa.umich.edu	Education
gsas.harvard.edu	Education
griffith.edu.au	Education
ieli.sa.edu.au	Education
jobs.ucsd.edu	Education
multimediaprint.psu.edu	Education
hls.harvard.edu	Education
clarkson.edu	Education
coe.k-state.edu	Education
ww2.graduate.ucf.edu	Education
uml.edu	Education
ssw.umich.edu	Education
studentaffairs.uncp.edu	Education
arch.pw.edu.pl	Education
byui.edu	Education
library.shu.edu	Education
ask.unimelb.edu.au	Education
lhup.edu	Education
career.opcd.wfu.edu	Education
admissions.illinois.edu	Education
askus.ecu.edu.au	Education
humanities.curtin.edu.au	Education
ctcd.edu	Education
niet.edu.au	Education
bacwritingfellows.commons.gc.cuny.edu	Education
albany.edu	Education
mq.edu.au	Education
web.mit.edu	Education
careers.rutgers.edu	Education
desrist2017.kit.edu	Education
library.humboldt.edu	Education
dartmouth.edu	Education
deakin.edu.au	Education
faculty.georgetown.edu	Education
ueeval.ucr.edu	Education
ctg.albany.edu	Education
educause.edu	Education
westernsydney.edu.au	Education
careers.ls.wisc.edu	Education
grad.mst.edu	Education
lib.rowan.edu	Education
uctap.universityofcalifornia.edu	Education
wts.indiana.edu	Education
libraries.indiana.edu	Education
hunter.cuny.edu	Education
engineering.pitt.edu	Education
libguides.css.edu	Education
umass.edu	Education
www1.rmit.edu.au	Education
eeweb.poly.edu	Education
jefferson.edu	Education
jerz.setonhill.edu	Education
su.edu.krd	Education
hws.edu	Education
asklib.gse.harvard.edu	Education
communicationcenter.gatech.edu	Education
career.fsu.edu	Education
cstw.osu.edu	Education
bio.research.ucsc.edu	Education
libraries.uky.edu	Education
gradcollege.okstate.edu	Education
press.uchicago.edu	Education
www3.nd.edu	Education
com.washington.edu	Education
careerservices.web.lehigh.edu	Education
saddleback.edu	Education
afe.easia.columbia.edu	Education
careerhelp.umn.edu	Education
online.uts.edu.au	Education
careercenter.umich.edu	Education
opencolleges.edu.au	Education
coloradotech.edu	Education
pointpark.edu	Education
ask.qut.edu.au	Education
gradschool.uoregon.edu	Education
grad.illinoisstate.edu	Education
students.graduate.ucf.edu	Education
kirtland.edu	Education
learningcentre.usyd.edu.au	Education
anso.williams.edu	Education
csaw.engineering.nyu.edu	Education
hamilton.edu	Education
nob.cs.ucdavis.edu	Education
achievement.ku.edu	Education
flinders.edu.au	Education
engineering.nd.edu	Education
canvas.ewu.edu	Education
engineering.unl.edu	Education
capital.edu	Education
honors.umn.edu	Education
writingcenter.mcdaniel.edu	Education
research.curtin.edu.au	Education
nuin.northwestern.edu	Education
monash.edu.au	Education
nyu.edu	Education
collegepuzzle.stanford.edu	Education
athens.edu	Education
postgraduate.uwa.edu.au	Education
ucdenver.edu	Education
mubs.edu.lb	Education
students.fvas.unimelb.edu.au	Education
admissions.tufts.edu	Education
sdsmt.edu	Education
jobs.uwa.edu.au	Education
studenthelp.secure.griffith.edu.au	Education
aitsl.edu.au	Education
ethics.csc.ncsu.edu	Education
aims.edu	Education
cs.washington.edu	Education
utas.edu.au	Education
daylesfordsc.vic.edu.au	Education
alumni.georgetown.edu	Education
gradschool.utah.edu	Education
uaa.alaska.edu	Education
bates.edu	Education
paloaltou.edu	Education
swinburne.edu.au	Education
tutoring.asu.edu	Education
ling.upenn.edu	Education
albright.edu	Education
abtech.edu	Education
www8.gsb.columbia.edu	Education
manoa.hawaii.edu	Education
guild.curtin.edu.au	Education
www2.cortland.edu	Education
greenriver.edu	Education
fhss.byu.edu	Education
ohio.edu	Education
cft.vanderbilt.edu	Education
ctl.yale.edu	Education
library.cornell.edu	Education
success.ucdavis.edu	Education
udayton.edu	Education
writesite.elearn.usyd.edu.au	Education
academia.edu	Education
bucks.edu	Education
jcu.edu.au	Education
music.indiana.edu	Education
www5.njit.edu	Education
careers.gmu.edu	Education
lib.ncsu.edu	Education
vanderbilt.edu	Education
www1.villanova.edu	Education
guides.lib.fsu.edu	Education
umt.edu	Education
extension.udel.edu	Education
vpul.upenn.edu	Education
library.unimelb.edu.au	Education
sbe.boun.edu.tr	Education
equip.sbts.edu	Education
dcc.edu.za	Education
iupui.edu	Education
kings.edu	Education
knight.as.cornell.edu	Education
ro.ecu.edu.au	Education
lib.berkeley.edu	Education
artsandsciences.sc.edu	Education
lonestar.edu	Education
career.uconn.edu	Education
www2.smumn.edu	Education
gradschool.psu.edu	Education
caldwell.edu	Education
fullerton.edu	Education
lawrence.edu	Education
commerce.virginia.edu	Education
john.curtin.edu.au	Education
guides.library.cornell.edu	Education
anderson.ucla.edu	Education
suny.edu	Education
unilearning.uow.edu.au	Education
lcc.edu	Education
uwa.edu.au	Education
teachingcenter.wustl.edu	Education
tafesa.edu.au	Education
careers.ucsc.edu	Education
degrees.griffith.edu.au	Education
studentaffairs.psu.edu	Education
careerservices.princeton.edu	Education
myusf.usfca.edu	Education
honors.nova.edu	Education
unmgrc.unm.edu	Education
writing2.richmond.edu	Education
international.mq.edu.au	Education
sps.nyu.edu	Education
theory.stanford.edu	Education
nap.edu.au	Education
wwwcc.ivytech.edu	Education
guides.library.uwa.edu.au	Education
westminster.edu	Education
w3.unisa.edu.au	Education
press.anu.edu.au	Education
cs.rochester.edu	Education
english.as.uky.edu	Education
butler.edu	Education
ldeo.columbia.edu	Education
hr.uwa.edu.au	Education
gustavus.edu	Education
cdu.edu.au	Education
library.albany.edu	Education
scranton.edu	Education
utdallas.edu	Education
gcc.edu	Education
awc.ashford.edu	Education
cws.illinois.edu	Education
trojan.troy.edu	Education
hydrodictyon.eeb.uconn.edu	Education
jou.ufl.edu	Education
cms.bsu.edu	Education
lib.umn.edu	Education
wallacecenter.rit.edu	Education
careercenter.georgetown.edu	Education
lib.washington.edu	Education
sislt.missouri.edu	Education
esc.edu	Education
highline.edu	Education
gradschool.louisiana.edu	Education
hampshire.edu	Education
career-ready.blogs.latrobe.edu.au	Education
ro.uow.edu.au	Education
coloradocollege.edu	Education
adb.anu.edu.au	Education
career.vt.edu	Education
mzoologia.uprrp.edu	Education
goaskalice.columbia.edu	Education
career.ucla.edu	Education
oneonta.edu	Education
extension.harvard.edu	Education
service.goshen.edu	Education
writingcenter.utah.edu	Education
eoss.asu.edu	Education
studentaffairs.pitt.edu	Education
wssu.edu	Education
library.sydney.edu.au	Education
pop.umn.edu	Education
baylor.edu	Education
wmc.dso.iastate.edu	Education
slu.edu	Education
career.ku.edu	Education
my.thechicagoschool.edu	Education
grammar.ccc.commnet.edu	Education
scas.nsw.edu.au	Education
uncw.edu	Education
library.hunter.cuny.edu	Education
uflib.ufl.edu	Education
gradschool.cornell.edu	Education
webster.edu	Education
nursing.jhu.edu	Education
lebow.drexel.edu	Education
pacifica.edu	Education
colfa.utsa.edu	Education
sc.edu	Education
open.edu.au	Education
potsdam.edu	Education
library.nd.edu.au	Education
library.unisa.edu.au	Education
cia.edu	Education
everestonline.edu	Education
library.cityu.edu	Education
blog.une.edu.au	Education
gsas.yale.edu	Education
careers.umd.edu	Education
infolab.stanford.edu	Education
apu.edu	Education
library.sdsu.edu	Education
stanford.edu	Education
my.kettering.edu	Education
det.wa.edu.au	Education
library.pitt.edu	Education
latrobe.edu.au	Education
apps.carleton.edu	Education
matc.english.txstate.edu	Education
babson.edu	Education
careercenter.wustl.edu	Education
fortlewis.edu	Education
english.illinois.edu	Education
books.publishing.monash.edu	Education
klab.smpp.northwestern.edu	Education
careers.qut.edu.au	Education
law.unimelb.edu.au	Education
collab.itc.virginia.edu	Education
blogs.umass.edu	Education
communications.fullerton.edu	Education
wpunj.edu	Education
career.ucf.edu	Education
swarthmore.edu	Education
amherst.edu	Education
columbiabc.edu	Education
e-education.psu.edu	Education
ncsu.edu	Education
apply.jhu.edu	Education
students.tufts.edu	Education
socialsciences.leiden.edu	Education
uvm.edu	Education
clas.wayne.edu	Education
careers.unc.edu	Education
wilkes.edu	Education
usfsp.edu	Education
nrel.colostate.edu	Education
awc.metu.edu.tr	Education
gradschool.duke.edu	Education
career.uncc.edu	Education
liberty.edu	Education
business.maricopa.edu	Education
lib.uts.edu.au	Education
umdearborn.edu	Education
bucknell.edu	Education
searchworks.stanford.edu	Education
ipoint.uwa.edu.au	Education
elearning.uq.edu.au	Education
mville.edu	Education
cmu.edu	Education
student.unsw.edu.au	Education
csuohio.edu	Education
smith.edu	Education
printing.unl.edu	Education
aibtglobal.edu.au	Education
ipscore.hsci.harvard.edu	Education
pdx.edu	Education
guides.ucf.edu	Education
students.mq.edu.au	Education
cue.edu.co	Education
honors.uci.edu	Education
iusb.edu	Education
orientation.uq.edu.au	Education
itali.uq.edu.au	Education
calstatela.edu	Education
web.uri.edu	Education
uc.edu	Education
rasmussen.edu	Education
uah.edu	Education
writingcenter.unc.edu	Education
graduate-school.uq.edu.au	Education
csun.edu	Education
odu.edu	Education
library.tulsa.ou.edu	Education
business.wsu.edu	Education
newcastle.edu.au	Education
ccd.rice.edu	Education
sites.tufts.edu	Education
content.csbs.utah.edu	Education
writingprogram.wsu.edu	Education
users.clas.ufl.edu	Education
uww.edu	Education
intranet.ecu.edu.au	Education
guides.lib.k-state.edu	Education
avalon.law.yale.edu	Education
writing.umn.edu	Education
career.oregonstate.edu	Education
uwlax.edu	Education
intranet.brenau.edu	Education
jhsph.edu	Education
writingcenter.tamu.edu	Education
careers.usc.edu	Education
oregonstate.edu	Education
umaine.edu	Education
users.ece.cmu.edu	Education
uow.edu.au	Education
ualr.edu	Education
wmich.edu	Education
eiu.edu	Education
laspositascollege.edu	Education
waisman.wisc.edu	Education
history.msu.edu	Education
libguides.mq.edu.au	Education
cau.edu	Education
miami.edu	Education
asu.edu	Education
gradresearch.unimelb.edu.au	Education
anthropology.stanford.edu	Education
honors.oregonstate.edu	Education
ipfw.edu	Education
resources.library.lemoyne.edu	Education
wesleyan.edu	Education
sierracollege.edu	Education
sta.uwi.edu	Education
uccs.edu	Education
career.berkeley.edu	Education
elc.polyu.edu.hk	Education
yalecollege.yale.edu	Education
usm.edu	Education
gradschool.fiu.edu	Education
upop.mit.edu	Education
rit.edu	Education
owl.english.purdue.edu	Education
cla.umn.edu	Education
sandiego.edu	Education
grad.ncsu.edu	Education
otterbein.edu	Education
communications.ucmerced.edu	Education
beaufortccc.edu	Education
education.nova.edu	Education
apps.spokane.edu	Education
uqp.uq.edu.au	Education
unh.edu	Education
grad-college.iastate.edu	Education
federation.edu.au	Education
library.nyu.edu	Education
sjsu.edu	Education
career.virginia.edu	Education
wrd.as.uky.edu	Education
westfield.ma.edu	Education
library.gmu.edu	Education
rollins.edu	Education
jenniferarnold.web.unc.edu	Education
guides.lib.monash.edu	Education
kfupm.edu.sa	Education
wcfia.harvard.edu	Education
moodle.une.edu.au	Education
composition.la.psu.edu	Education
alumni.umich.edu	Education
csus.edu	Education
iuplr.uic.edu	Education
transportation.umd.edu	Education
colby.edu	Education
csustan.edu	Education
tamuc.edu	Education
guides.library.ucla.edu	Education
careers.unl.edu	Education
gradschool.umbc.edu	Education
career.louisiana.edu	Education
ccis.edu	Education
students.case.edu	Education
sac.edu	Education
stevenson.edu	Education
usq.edu.au	Education
unl.edu	Education
subjectguides.library.unsw.edu.au	Education
lib.vt.edu	Education
temple.edu	Education
writing.upenn.edu	Education
library.whitman.edu	Education
web.wpi.edu	Education
honors.gsu.edu	Education
philosophy.fas.harvard.edu	Education
www2.gsu.edu	Education
unisa.edu.au	Education
anthropology.columbian.gwu.edu	Education
student.uwa.edu.au	Education
admissions.berkeley.edu	Education
sites.jcu.edu	Education
newarkwww.rutgers.edu	Education
aait.psu.edu	Education
gsrc.ucla.edu	Education
adc.library.usyd.edu.au	Education
uwm.edu	Education
libweb.uml.edu	Education
writingproject.fas.harvard.edu	Education
graduateschool.utsa.edu	Education
peabody.jhu.edu	Education
writing-speech.dartmouth.edu	Education
monash.edu	Education
ivytech.edu	Education
mals.dartmouth.edu	Education
cehd.umn.edu	Education
ogaps.tamu.edu	Education
eecs.umich.edu	Education
www2.pitt.edu	Education
evl.uic.edu	Education
library.wisc.edu	Education
tgs.northwestern.edu	Education
cmich.edu	Education
swinburneonline.edu.au	Education
libguides.nps.edu	Education
grad.berkeley.edu	Education
llt.msu.edu	Education
career.arizona.edu	Education
web.njit.edu	Education
mba.haas.berkeley.edu	Education
slc.berkeley.edu	Education
davidson.edu	Education
tamug.edu	Education
apus.edu	Education
dmacc.edu	Education
monmouth.edu	Education
hireacane.miami.edu	Education
stat.berkeley.edu	Education
union.edu	Education
butte.edu	Education
readingwritinghotline.edu.au	Education
honors.umass.edu	Education
columbia.edu	Education
dyslexiahelp.umich.edu	Education
piu.edu	Education
lclark.edu	Education
learnonline.canberra.edu.au	Education
sagu.edu	Education
ee.ucr.edu	Education
blogs.umb.edu	Education
humanities.uwa.edu.au	Education
collegeforadultlearning.edu.au	Education
coursesearch.unimelb.edu.au	Education
faculty.etsu.edu	Education
uab.edu	Education
web.stanford.edu	Education
news.aces.edu	Education
liberalarts.utexas.edu	Education
writingcenter.fas.harvard.edu	Education
open.edu	Education
library.qut.edu.au	Education
tutoringcenter.fullcoll.edu	Education
primoa.library.unsw.edu.au	Education
dickinson.edu	Education
writing.wisc.edu	Education
eastern.edu	Education
clas.uiowa.edu	Education
admissions.txstate.edu	Education
udel.edu	Education
gettysburg.edu	Education
cms.qut.edu.au	Education
eaa.unsw.edu.au	Education
schools.nsw.edu.au	Education
hmc.edu	Education
fordham.edu	Education
cse.unsw.edu.au	Education
researchguides.austincc.edu	Education
rockhursths.edu	Education
midland.edu	Education
elliott.gwu.edu	Education
sydney.edu.au	Education
iona.edu	Education
etsu.edu	Education
ccss.osu.edu	Education
wm.edu	Education
commons.hostos.cuny.edu	Education
services.unimelb.edu.au	Education
careerservices.gwu.edu	Education
schoolatoz.nsw.edu.au	Education
careers.umbc.edu	Education
bergen.edu	Education
policies.anu.edu.au	Education
writing.ku.edu	Education
oyc.yale.edu	Education
academics.nsuok.edu	Education
library.buffalo.edu	Education
drexel.edu	Education
newcollege.asu.edu	Education
sis.uwa.edu.au	Education
mason.gmu.edu	Education
library.rochester.edu	Education
grady.uga.edu	Education
spo.berkeley.edu	Education
careerservices.uic.edu	Education
library.rit.edu	Education
sage.edu	Education
smc.edu	Education
uscupstate.edu	Education
www2.tulane.edu	Education
rackham.umich.edu	Education
reed.edu	Education
people.rice.edu	Education
libguides.gwumc.edu	Education
literature.bennington.edu	Education
louisville.edu	Education
staff.camas.wednet.edu	Education
engr.iupui.edu	Education
anu.edu.au	Education
bcn.uprrp.edu	Education
qut.edu.au	Education
new.library.arizona.edu	Education
tulane.edu	Education
faculty.chicagobooth.edu	Education
library.drexel.edu	Education
programsandcourses.anu.edu.au	Education
my.unisa.edu.au	Education
studyabroad.ucdavis.edu	Education
lib.usf.edu	Education
mica.edu	Education
northwestern.edu	Education
umuc.edu	Education
emedia.rmit.edu.au	Education
ocs.fas.harvard.edu	Education
library.uic.edu	Education
vprgs.msu.edu	Education
colum.edu	Education
life.curtin.edu.au	Education
ecology.ucdavis.edu	Education
brownsenglish.edu.au	Education
lib.msstate.edu	Education
hosptrain.vic.edu.au	Education
careers.unimelb.edu.au	Education
web.iit.edu	Education
buffalo.edu	Education
gse.buffalo.edu	Education
honors.wsu.edu	Education
msu.edu	Education
kumc.edu	Education
caw.ceu.edu	Education
infoguides.rit.edu	Education
journalism.missouri.edu	Education
ceas.uc.edu	Education
goforward.harpercollege.edu	Education
web.colby.edu	Education
abacus.bates.edu	Education
news.stanford.edu	Education
guides.nyu.edu	Education
pwr.la.psu.edu	Education
pennstatelearning.psu.edu	Education
grad.wisc.edu	Education
gvsu.edu	Education
uq.edu.au	Education
k-state.edu	Education
academicintegrity.curtin.edu.au	Education
bc.edu	Education
grad.usf.edu	Education
ugs.utexas.edu	Education
stcloudstate.edu	Education
at.blogs.wm.edu	Education
libraries.wm.edu	Education
allisonlibrary.regent-college.edu	Education
writingcenter.pitt.edu	Education
libguides.adelaide.edu.au	Education
career.ucsd.edu	Education
web.csulb.edu	Education
health.harvard.edu	Education
hcii.cmu.edu	Education
ruf.rice.edu	Education
guides.library.illinois.edu	Education
careerservices.wvu.edu	Education
brown.edu	Education
news.ncsu.edu	Education
vmi.edu	Education
academicguides.waldenu.edu	Education
ocw.usu.edu	Education
wac.colostate.edu	Education
heath.gwu.edu	Education
home.nwciowa.edu	Education
brandeis.edu	Education
baruch.cuny.edu	Education
une.edu.au	Education
ccm.edu	Education
colorado.edu	Education
libguides.lmu.edu	Education
press.umich.edu	Education
writing.msu.edu	Education
library.csuohio.edu	Education
libguides.murdoch.edu.au	Education
vu.edu.au	Education
libraries.luc.edu	Education
binghamton.edu	Education
publishing.monash.edu	Education
bu.edu	Education
mitpress.mit.edu	Education
libguides.usc.edu	Education
libraries.uark.edu	Education
uts.edu.au	Education
northeastern.edu	Education
library.ucla.edu	Education
une.edu	Education
depts.washington.edu	Education
sites.allegheny.edu	Education
careernetwork.msu.edu	Education
cs.purdue.edu	Education
sites.duke.edu	Education
lib.msu.edu	Education
stemcell.yale.edu	Education
animt.edu.au	Education
bethel.wa.edu.au	Education
ccp.rpi.edu	Education
cs.colostate.edu	Education
bae.ncsu.edu	Education
citewrite.qut.edu.au	Education
kent.edu	Education
orkts.cuhk.edu.hk	Education
gradschool.uky.edu	Education
drummondm-p.schools.nsw.edu.au	Education
ap.cityu.edu.hk	Education
admissions.upenn.edu	Education
www2.hawaii.edu	Education
unf.edu	Education
ham.miamioh.edu	Education
cpp.edu	Education
mass.edu	Education
hup.harvard.edu	Education
essaydone.co.uk	Essayexperts
papers-land.com	Essayexperts
7dollaressay.com	Essayexperts
elitewritings.com	Essayexperts
essays-writer.net	Essayexperts
prime-essays.co.uk	Essayexperts
buy-essays-papers.org	Essayexperts
primethesis.com	Essayexperts
topwritingservice.com	Essayexperts
primeessays.co.uk	Essayexperts
writer-elite.com	Essayexperts
primeessays.com	Essayexperts
specialessays.com	Essayexperts
primedissertations.com	Essayexperts
master-dissertations.com	Essayexperts
supremeessays.com	Essayexperts
primewritings.com	Essayexperts
marvelousessays.com	Essayexperts
best-essays-writers.com	Essayexperts
gold-essays.com	Essayexperts
4writers.net	Essayexperts
prime-essay.org	Essayexperts
top-writing-services.com	Essayexperts
perfectessaysonline.com	Essayexperts
bestwritingservice.com	Essayexperts
qualitycustomessays.com	Essayexperts
writings-centre.com	Essayexperts
marvelousessays.co.uk	Essayexperts
superessay.org	Essayexperts
essayswriters.com	Essayexperts
essaysprofessors.com	Essayexperts
essays-masters.com	Essayexperts
exclusive-paper.com	Essayexperts
exclusivepapers.com	Essayexperts
qualityessay.com	Essayexperts
prime-essay.net	Essayexperts
assignmentace.co.uk	Essayexperts
essaypro.com	Essaypro
essay.uk.com	Essayuk
buyessay-s.com	EssayWritingServices
ukessaysreview.com	EssayWritingServices
smartessaywritingservice.com	EssayWritingServices
essaywritingservice-s.com	EssayWritingServices
classyresumewriter.com	EssayWritingServices
resume-service.org	EssayWritingServices
essay-editor.net	EssayWritingServices
experteditor.com.au	Experteditor
flashpapers.com	Flashpapers
maine.gov	Gov
grants.nih.gov	Gov
mass.gov	Gov
ergo.slv.vic.gov.au	Gov
youthcentral.vic.gov.au	Gov
sosnc.gov	Gov
lincolnca.gov	Gov
dfs.ny.gov	Gov
nes.land.vic.gov.au	Gov
beta.companieshouse.gov.uk	Gov
slv.vic.gov.au	Gov
lam.alaska.gov	Gov
careercentre.dtwd.wa.gov.au	Gov
employment.gov.au	Gov
uscode.house.gov	Gov
educationusa.state.gov	Gov
pinalcountyaz.gov	Gov
jobaccess.gov.au	Gov
library.armadale.wa.gov.au	Gov
nottinghamcity.gov.uk	Gov
treasurydirect.gov	Gov
vistacampus.gov	Gov
greensboro-nc.gov	Gov
nla.gov.au	Gov
naa.gov.au	Gov
humanrights.gov.au	Gov
nia.nih.gov	Gov
studentaid.ed.gov	Gov
depi.vic.gov.au	Gov
richmond.gov.uk	Gov
schools.nyc.gov	Gov
hursttx.gov	Gov
ramint.gov.au	Gov
nidirect.gov.uk	Gov
webapps.dol.gov	Gov
nationalcareersservice.direct.gov.uk	Gov
liveinvictoria.vic.gov.au	Gov
joondalup.wa.gov.au	Gov
training.nih.gov	Gov
australia.gov.au	Gov
ppol.passports.gov.au	Gov
brimbanklibraries.vic.gov.au	Gov
jobsearch.gov.au	Gov
gladstonelibraries.qld.gov.au	Gov
usfa.fema.gov	Gov
plconnect.slq.qld.gov.au	Gov
aifs.gov.au	Gov
education.vic.gov.au	Gov
vets.gov	Gov
azed.gov	Gov
aiatsis.gov.au	Gov
medicare.gov	Gov
calhr.ca.gov	Gov
royalgreenwich.gov.uk	Gov
studyinaustralia.gov.au	Gov
nma.gov.au	Gov
yprl.vic.gov.au	Gov
santafecountynm.gov	Gov
yarracity.vic.gov.au	Gov
nationalarchives.gov.uk	Gov
japan.embassy.gov.au	Gov
fairfaxcounty.gov	Gov
ahrq.gov	Gov
belfastcity.gov.uk	Gov
info.healthconnect.vermont.gov	Gov
qld.gov.au	Gov
federalreserve.gov	Gov
screenaustralia.gov.au	Gov
parliament.nsw.gov.au	Gov
librarycatalogue.hobsonsbay.vic.gov.au	Gov
ourlibrary.mornpen.vic.gov.au	Gov
pittwater.nsw.gov.au	Gov
library.frankston.vic.gov.au	Gov
kids.usa.gov	Gov
library.pima.gov	Gov
dvlaregistrations.direct.gov.uk	Gov
ahpra.gov.au	Gov
southwark.gov.uk	Gov
marketplace.cms.gov	Gov
ncbi.nlm.nih.gov	Gov
data.aims.gov.au	Gov
files.eric.ed.gov	Gov
new.enfield.gov.uk	Gov
usajobs.gov	Gov
australiacouncil.gov.au	Gov
dhs.gov	Gov
assignment.uspto.gov	Gov
weather.gov	Gov
cclc.vic.gov.au	Gov
irs.gov	Gov
environment.gov.au	Gov
michigan.gov	Gov
border.gov.au	Gov
edu.gov.on.ca	Gov
coventry.gov.uk	Gov
tameside.gov.uk	Gov
sba.gov	Gov
salisbury.sa.gov.au	Gov
library.austintexas.gov	Gov
access.wa.gov	Gov
my.americorps.gov	Gov
westtorrens.sa.gov.au	Gov
brevardfl.gov	Gov
valeofglamorgan.gov.uk	Gov
gojobs.gov.on.ca	Gov
eliteessaywriters.com	Govitall
au.chicessays.com	Govitall
yourwriters.net	Govitall
writingbee.org	Govitall
essay-company.com	Govitall
courseworkwriter.co.uk	Govitall
royal-essay.co.uk	Govitall
masterpapers.com	Govitall
essay-writing-service-help.com	Govitall
buy-researchpapers.net	Govitall
royalessays.co.uk	Govitall
payforessay.net	Govitall
helpresume.com	Govitall
essay-online.co.uk	Govitall
customessaywritingservice.ae	Govitall
grademiners.com	Govitall
essaywriters.com.au	Govitall
researchpapernow.net	Govitall
cleveressay.co.uk	Govitall
customresearchpaper.net	Govitall
valwriting.net	Govitall
essaywritersite.com	Govitall
fastessays.co.uk	Govitall
essaylab.co.uk	Govitall
grandpaperwriting.com	Govitall
homeworkstuff.com	Govitall
bestessay4u.net	Govitall
buytermpapersonline.net	Govitall
dissertationworld.com	Govitall
writemypapers.guru	Govitall
chicessays.com	Govitall
essayking.net	Govitall
custom-writer-help.org	Govitall
essay-capital.net	Govitall
ma-dissertations.com	Govitall
bestessaysforsale.net	Govitall
cheapcustompaper.com	Govitall
essaywritingservicehelp.co.uk	Govitall
dissertation-service.co.uk	Govitall
studentshare.net	Govitall
writessay4me.co.uk	Govitall
coursework-writing-service.co.uk	Govitall
writing-college-essay.com	Govitall
gurutermpaper.com	Govitall
custom-essay-writing.co.uk	Govitall
premiumessays.co.uk	Govitall
termpaperhelponline.org	Govitall
writingbee.com	Govitall
ukessaywriter.co.uk	Govitall
buyessays.com.au	Govitall
custom-writings.co.uk	Govitall
essaybuyers.com	Govitall
servicessay.com	Govitall
dissertationmart.co.uk	Govitall
gurudissertation.com	Govitall
termpaperwriter.org	Govitall
essaytrust.com	Govitall
aussieessaywriter.com.au	Govitall
cheapcustompaper.net	Govitall
customessaysinuk.com	Govitall
samedayessay.me	Govitall
grademiners.co.uk	Govitall
essayonlinestore.com	Govitall
pay-for-essay.co.uk	Govitall
scholarshipessay.org	Govitall
essaysale.net	Govitall
writingpapershelp.com	Govitall
essaywriter.org	Govitall
uk-custom-essays.com	Govitall
essay-24.com	Govitall
fastessaysonline.co.uk	Govitall
englishessays.net	Govitall
urgent-essay.com	Govitall
au.grademiners.com	Govitall
sherlockessay.co.uk	Govitall
bestresearchpaper.com	Govitall
royalessay.org	Govitall
okessay.co.uk	Govitall
resume-for-you.com	Govitall
essay-company.co.uk	Govitall
essaywritings.com.au	Govitall
custom-writing.co.uk	Govitall
customessays.co.uk	Govitall
resumes-writer.com	Govitall
britishessayswriters.co.uk	Govitall
papernow.org	Govitall
essayswriters.net	Govitall
essayseducation.com	Govitall
papersnetwork.net	Govitall
guruessay.com	Govitall
myessayservice.com	Govitall
dissertation-writing-tips.com	Govitall
essayonlineservice.org	Govitall
buyessay.net	Govitall
britishessaywriter.org.uk	Govitall
valwriting.com	Govitall
assignmenthelponline.co.uk	Govitall
ma-dissertations.org	Govitall
superiorcontent.com	Govitall
bestessaypro.com	Govitall
essay-forme.com	Govitall
urgentessays.co.uk	Govitall
customessaywriter.co.uk	Govitall
buy-essays-fast.net	Govitall
buycustomwriting.com	Govitall
samedayessay.com	Govitall
custom-writing-online.co.uk	Govitall
coursework-writing.co.uk	Govitall
valwritings.net	Govitall
bestessayes.com	Govitall
getessay.org	Govitall
write-my-essay-online.org	Govitall
idealessay.co.uk	Govitall
payforessay.eu	Govitall
bestessays-writers.com	Govitall
essaysmonster.net	Govitall
essay4me.org	Govitall
customtermpapershelp.net	Govitall
writemyessayservice.co.uk	Govitall
proessays.biz	Govitall
writing4you.com	Govitall
custom-essay-help-writing.com	Govitall
masterpapers.com.au	Govitall
myexcellentwriter.com	Govitall
custom-essays.co.uk	Govitall
termpaperwriting.biz	Govitall
okessays.com	Govitall
essayswriter.net	Govitall
essay-writer-online.org	Govitall
studyhamster.com	Govitall
essays-writing-for-me.com	Govitall
onedayessay.com	Govitall
papershelps.com	Govitall
essay-writing-online.org	Govitall
cover-letter-writing.com	Govitall
essaywriterguide.com	Govitall
custom-essays-writing.co.uk	Govitall
paramountessays.com	Govitall
onlinebuyessay.com	Govitall
get-essay.com	Govitall
sigmaessays.com	Govitall
essaywritinglab.com	Govitall
customdissertationwriters.com	Govitall
customessaysonline.org	Govitall
essay-writer-usa.com	Govitall
essay-writing-service.co	Govitall
courseworkservice.com	Govitall
papersfor.sale	Govitall
essaywriting-au.com	Govitall
order-an-essay.com	Govitall
samedayessay.org	Govitall
dissertationdatabase.co.uk	Govitall
writingbee.info	Govitall
essay4less.com	Govitall
thesispanda.com	Govitall
essayonlinestore.org	Govitall
researchpaperwriter.net	Govitall
essaycapitals.com	Govitall
writemyessaystoday.com	Govitall
buyessaysonlinecheap.net	Govitall
abcpaperwriter.com	Govitall
craftanessay.com	Govitall
essaycastle.co.uk	Govitall
essay-writing.com.au	Govitall
excellentessaywriter.com	Govitall
samedayessays.org	Govitall
getresearchpaper.com	Govitall
essayforme.com	Govitall
write-my-essay-online.net	Govitall
grandresume.com	Govitall
order-essay.com	Govitall
bestessay4u.com	Govitall
master-of-papers.com	Govitall
writeapaperfor.me	Govitall
essaycapital.com	Govitall
termpapermonster.com	Govitall
mydissertationwriting.com	Govitall
dissertationshop.co.uk	Govitall
dissertation-help-online.co.uk	Govitall
essayhero.co.uk	Govitall
writeessayfast.com	Govitall
customwritingbee.com	Govitall
essaycapital.org	Govitall
termpaper.help	Govitall
buycustomessayonline.net	Govitall
einstein-writers.com	Govitall
researchpaperking.com	Govitall
essayhelpservice.net	Govitall
top-research-paper.net	Govitall
top-essay.co.uk	Govitall
mywritersreview.com	Govitall
buy-researchpapers.org	Govitall
britishessaywriter.co.uk	Govitall
thedissertationhouse.com	Govitall
buyessaynow.net	Govitall
bestessaysservice.com	Govitall
onlinecustomessays.com	Govitall
essayresearchwriting.com	Govitall
essaychecker.net	Govitall
samedayessays.net	Govitall
thepaperwriting.com	Govitall
essay.cafe	Govitall
bestessay4u.me	Govitall
vizwriting.com	Govitall
wowritingservice.com	Govitall
goodwriting2u.com	Govitall
writemypaper-help.com	Govitall
papernow.co.uk	Govitall
myessayservice.org	Govitall
professionalessayhelp.com	Govitall
essays-for-me.com	Govitall
writemyessaynow.org	Govitall
assignmentbaron.net	Govitall
essaysreviewer.com	Govitall
essaysource.com	Govitall
ukacademicwriting.co.uk	Govitall
chiefessays.net	Govitall
paperwriters.org	Govitall
custom-writer-help.net	Govitall
eduaidguru.com	Govitall
payforessay.co.uk	Govitall
ukessaynow.com	Govitall
onlineessayshelp.com	Govitall
secureessays.com	Govitall
writingalab.report	Govitall
do-my-essays.com	Govitall
dissertationforme.com	Govitall
diamondessays.com	Govitall
studyjumper.com	Govitall
fireessay.com	Govitall
ca.grademiners.com	Govitall
cheapwritingservices.org	Govitall
gurudissertation.net	Govitall
unemployedprofessors.xyz	Govitall
pay4essays.net	Govitall
customessays-uk.me	Govitall
eduhamster.com	Govitall
essaywriterforyou.com	Govitall
dissertations2buy.com	Govitall
scoobydomyessay.com	Govitall
proessaywritingservice.net	Govitall
essay-writer.info	Govitall
researchpaperforyou.com	Govitall
essaywritingservicerapid.com	Govitall
thehomeworkportal.com	Govitall
fastessayhelp.com	Govitall
essaywriters247.com	Govitall
paperwriterhelp.net	Govitall
termpapers-for-sale.com	Govitall
buyessayfast.com	Govitall
writemypaperonline.net	Govitall
writemyessayrapid.com	Govitall
10pagepapers.com	Govitall
skillroads.com	Govitall
theessayclub.com	Govitall
mytermpaperwriter.net	Govitall
getessay.com	Govitall
college-essay-writing-service.com	Govitall
essay-writing-helper.org	Govitall
guruessays.com	Govitall
goodhired.com	Govitall
helpwritemyessay.co.uk	Govitall
onlinedissertationservice.com	Govitall
gurucoursework.com	Govitall
uk.grademiners.com	Govitall
custom-writings.net	Govitall
expert-writers.net	Govitall
theessaywriter.net	Govitall
assignmenthelpers.com.au	Hexa
myessaygeek.com	Hexa
ezdissertation.com	Hexa
paperwriting.company	Hexa
123midterm.com	Hexa
writemypaper.today	Hexa
writingjet.com	Hexa
getpaperdone.com	Hexa
domyhomework123.com	Hexa
myessaywriter.org	Hexa
mycustomwriting.com	Hexa
dissertationland.com	Hexa
writingeek.com	Hexa
myhomeworkaid.com	Hexa
quickwriter.com	Hexa
mypaperhelper.com	Hexa
custompapers247.com	Hexa
writersdepartment.com	Hexa
resumesland.com	Hexa
termpapereasy.com	Hexa
bestessayhelp.com	Hexa
dissertationexpert.org	Hexa
mypaperwriting.com	Hexa
admissionland.com	Hexa
writemypaper123.com	Hexa
writingforless.com	Hexa
dissertationhero.org	Hexa
writemyessay.today	Hexa
buyessay.cheap	Hexa
thesishelpers.com	Hexa
paperwritten.com	Hexa
papercamp.org	Hexa
mycustomessay.com	Hexa
myessaywriting.com	Hexa
craftmyessay.com	Hexa
usessaywriters.com	Hexa
hotdissertation.com	Hexa
termpaperpro.com	Hexa
ecustomwriting.com	Hexa
helpmypaper.com	Hexa
dissertationagent.com	Hexa
essaycamp.com	Hexa
vivathesis.com	Hexa
homeworkcamp.com	Hexa
nextwriting.com	Hexa
mydissertationshop.com	Hexa
proessaywriters.com	Hexa
thesisgeek.com	Hexa
mythesiswriters.com	Hexa
buyessayonline.org	Hexa
buyessayeasy.com	Hexa
termpaperwritten.com	Hexa
123homework.com	Hexa
123dissertations.com	Hexa
zessay.com	Hexa
mypaperdone.com	Hexa
abovecollege.com	Hexa
123writings.com	Hexa
writemyessayz.com	Hexa
termpaperwizard.com	Hexa
vivaessays.com	Hexa
writeforce.com	Hexa
essay.company	Hexa
ezwritingservice.com	Hexa
mythesiswriting.com	Hexa
123customessay.com	Hexa
findessaywriter.com	Hexa
pimpmypaper.com	Hexa
academicwritersonline.com	Hexa
dissertationteam.com	Hexa
essaywriter4hire.com	Hexa
essaywriter247.com	Hexa
ezcollegepapers.com	Hexa
mypaperwriter.com	Hexa
essaylab.org	Hexa
dissertationgeek.com	Hexa
essayscenter.com	Hexa
mydissertations.com	Hexa
thesisrush.com	Hexa
myhomeworkdone.com	Hexa
assignmentgeek.com	Hexa
customessaynow.com	Hexa
assignmentcamp.com	Hexa
essaystore.org	Hexa
dissertationdepot.com	Hexa
getessaywritten.com	Hexa
ezassignmenthelp.com	Hexa
eaglewriting.com	Hexa
acemypaper.com	Hexa
expressessayhelp.com	Hexa
paperwritingpros.com	Hexa
ibuyessay.com	Hexa
dissertation.ninja	Hexa
papers4college.com	Hexa
ewritingservice.com	Hexa
paythegeek.com	Hexa
dissertation.cheap	Hexa
gobuyessay.com	Hexa
123termpapers.com	Hexa
qessay.com	Hexa
termpaperhub.com	Hexa
essay2go.com	Hexa
custompaperhelp.com	Hexa
ehomeworkservice.com	Hexa
myessaypal.com	Hexa
ezpaperwriting.com	Hexa
thesismonster.com	Hexa
dissertationediting.company	Hexa
editors-service.com	Hexa
myessayhelper.com	Hexa
essaymill.com	Hexa
ezacademicpapers.com	Hexa
pen.camp	Hexa
homeworkhelpdesk.org	Hexa
weeklyessay.com	Hexa
proessayreviews.com	Hexa1
customessaysservices.com	Hexa1
stablewriters.com	Hexa1
onlinespeechwriting.com	Hexa1
personal-statement.com	ivoryresearch
cv-shop.com	ivoryresearch
ivoryresearch.com	ivoryresearch
livewebtutors.com	livewebtutors
myassignmenthelpau.com	livewebtutors
my-writing-expert.org	Livingstone
myessaywriter.net	Myessaywriter
expertpaperhelp.com	Netfix
essaybrokers.com	Netfix
ratedwriting.com	Netfix
getpersonalessays.com	Netfix
bestwritersonline.com	Netfix
getgoodgrade.com	Netfix
glossessays.com	Netfix
topessaywriting.org	Netfix
bestaustralianwriters.com	Netfix
awardedessay.com	Netfix
greenessay.com	Netfix
trustmypaper.com	Netfix
bestxessays-au.com	Netfix
paperwriting.reviews	Netfix
bigassignments.com	Netfix
topwritingreviews.com	Netfix
essaythinker.com	Netfix
vipcustomwriting.com	Netfix
ukwritings.com	Netfix
essayroo.com	Netfix
mastergrades.com	Netfix
australian-writings.com	Netfix
essayplanet.org	Netfix
globalwritings.com	Netfix
gradeonfire.com	Netfix
essaystate.com	Netfix
trustessaywriting.com	Netfix
buyessayordie.com	Netfix
poweredessays.com	Netfix
supremedissertations.com	Netfix
trustessays.com	Netfix
smartcustomwriting.org	Netfix
procustomwriting.com	Netfix
alltopreviews.com	Netfix
evoessay.com	Netfix
urgentessaywriting.com	Netfix
boomessays.com	Netfix
gloriousessays.com	Netfix
essaysdeluxe.com	Netfix
topwritersreview.com	Netfix
getacademichelp.com	Netfix
reallyprofessionalessays.com	Netfix
smartpaperhelp.com	Netfix
uktopwriters.com	Netfix
essaythinker.net	Netfix
australianhelp.com	Netfix
papersboard.com	Netfix
wwwritingservice.com	Netfix
ghostprofessors.com	Netfix
writingdaddy.com	Netfix
essayrepublic.com	Netfix
essays.solutions	Netfix
lordofpapers.com	Netfix
topwritersreviews.com	Netfix
okdissertations.com	Netfix
smartcustomwriting.net	Netfix
essaystate.net	Netfix
oxessays.com	Netfix
grabmyessay.com	Netfix
bestessay.education	Netfix
assignmentmountain.com	Netfix
academized.com	Netfix
ineedessayhelp.com	Netfix
resumescentre.com	Netfix
x-essays.com	Netfix
profesia.sk	Netfix
resumention.com	Netfix
premieressay.net	Netfix
paperfellows.com	Netfix
topcanadianwriters.com	Netfix
classyessay.com	Netfix
rewardedessays.com	Netfix
smartcustomwriting.com	Netfix
mybestessays.org	Netfix
myessayslab.com	Netfix
buyprofessays.com	Netfix
essaykittens.com	Netfix
eliteassignmenthelp.com	Netfix
trusteddissertations.com	Netfix
essaypanda.org	Netfix
resumes.expert	Netfix
hitthegrade.com	Netfix
profesia.cz	Netfix
premieressay.com	Netfix
bestbritishessays.com	Netfix
canadianwritings.com	Netfix
custom-essay.net	New company 1
essay.ws	New company 1
essaywriting.expert	New company 1
writemyservice.com	New company 1
essay.tv	New company 1
onlinessay.com	New company 1
londonproofreaders.co.uk	New company 19
essaywriters.us	New company 2
universityessaywriting.com	New company 2
eduessay.com	New company 2
essay-911.com	New company 2
essayformats.com	New company 2
paysomeonetowritemypaper.com	New company 2
custom-writings.us	New company 2
autocadhelp.net	New company 25
javahelponline.com	New company 25
computerscienceassignmentshelp.com	New company 25
assignmentinc.com	New company 25
academicpaperwriter.com	New company 25
matlabhelp.com	New company 25
chelponline.com	New company 25
auditinghelp.com	New company 25
phphelponline.com	New company 25
accountingassignments.help	New company 25
statskey.com	New company 25
dissertationwriting.uk	New company 25
cheapessaywriting.net	New company 26
assignmentaid.net	New company 26
affordablewriting.net	New company 26
essaycorp.co.uk	New company 27
essaymall.co.uk	New company 27
essayace.co.uk	New company 27
assignmentdone.co.uk	New company 27
instantessay.co.uk	New company 27
aoneassignments.com	New company 27
customassignment.com	New company 27
dissertationplus.co.uk	New company 27
essaymania.co.uk	New company 27
trueessayhelp.co.uk	New company 27
assignmentmaster.co.uk	New company 27
ordercollegepapers.com	New company 27
assignmentcamp.co.uk	New company 27
orderessayonline.com	New company 27
domyessayuk.com	New company 27
aonepapers.com	New company 27
rushpapers.co.uk	New company 27
essayplus.co.uk	New company 27
essaytigers.co.uk	New company 27
chiefessays.com	New company 27
dissertationpoint.co.uk	New company 27
groovyessays.com	New company 27
assignmentarena.co.uk	New company 27
hirepaperwriter.com	New company 27
assignmentcompany.com	New company 27
assignmentvalley.co.uk	New company 27
helpinessays.com	New company 27
courseworkonline.co.uk	New company 27
domyassignmentforme.com	New company 27
speedycoursework.co.uk	New company 27
dissertationworks.co.uk	New company 27
essaylounge.co.uk	New company 27
assignmentkeen.com	New company 27
masterpaperwriters.com	New company 27
assignmentmoz.co.uk	New company 27
assignmentcorner.co.uk	New company 27
assignmentgeek.co.uk	New company 27
essaycampus.co.uk	New company 27
essayempire.co.uk	New company 27
courseworkspot.co.uk	New company 27
buyassignment.net	New company 27
courseworkbuzz.co.uk	New company 27
courseworkpoint.co.uk	New company 27
trueassignmenthelp.co.uk	New company 27
helpdohomework.com	New company 27
ezassignmenthelp.co.uk	New company 27
essaybuzz.co.uk	New company 27
getcollegepapers.com	New company 27
dissertationtime.co.uk	New company 27
dissertationarena.co.uk	New company 27
courseworkmojo.co.uk	New company 27
assignmentbay.co.uk	New company 27
assignmentland.co.uk	New company 27
bestassignmentservice.com	New company 27
buyassignment.com	New company 27
assignmentcorp.co.uk	New company 27
writemyessaynow.co.uk	New company 27
dissertationinn.co.uk	New company 27
toppaperwriter.com	New company 27
finestassignments.co.uk	New company 27
aoneassignment.com	New company 27
researchpapertown.com	New company 27
gethomeworkonline.com	New company 27
essayhelpdeal.co.uk	New company 27
midnightessays.com	New company 27
essayglobe.co.uk	New company 27
assignmentninja.co.uk	New company 27
peakdissertation.co.uk	New company 27
domyessaynow.co.uk	New company 27
essaymojo.co.uk	New company 27
getessaydone.com	New company 27
dissertationclub.co.uk	New company 27
dissertationavenue.co.uk	New company 27
brilliantessays.net	New company 27
ontimepaper.com	New company 27
courseworkhelppros.co.uk	New company 27
uaeassignmentwriting.help	New company 27
dissertationcorp.co.uk	New company 27
courseworkclub.co.uk	New company 27
mightyessays.co.uk	New company 27
freshessays.co.uk	New company 27
essaythinker.co.uk	New company 27
needpaperhelp.com	New company 27
essaywriter.com.au	New company 27
dissertationmojo.co.uk	New company 27
paperdome.co.uk	New company 27
assignmentempire.co.uk	New company 27
assignmentgurus.co.uk	New company 27
chiefpapers.com	New company 27
assignmenthub.co.uk	New company 27
buyessaytoday.com	New company 27
primeassignment.com	New company 27
buyassignmentservice.com	New company 27
assignmentlabs.co.uk	New company 27
mycollegeessay.com	New company 27
myassignmentservice.com	New company 27
dissertationmall.co.uk	New company 27
makemyessay.com	New company 27
assignmentdoer.co.uk	New company 27
mypaperwriter.co.uk	New company 27
customessayhelp.com	New company 27
australianessay.com	New company 27
dissertationhouse.co.uk	New company 27
purchaseessaysonline.com	New company 27
ordermypapers.com	New company 27
writingessay.co.uk	New company 27
essayavenue.co.uk	New company 27
courseworkgeek.co.uk	New company 27
assignmentmojo.co.uk	New company 27
hireessaywriter.com	New company 27
dissertationhelpdeal.co.uk	New company 27
dissertationcube.co.uk	New company 27
absoluteessays.com	New company 27
assignmentdoer.com	New company 27
essayclick.co.uk	New company 27
brilliantassignments.com	New company 27
aoneessays.net	New company 27
courseworklabs.co.uk	New company 27
assignmenthelpdeal.co.uk	New company 27
assignmentcorp.com	New company 27
essayspot.co.uk	New company 27
writingbunch.co.uk	New company 27
aussieassignment.com	New company 27
allwritingsource.co.uk	New company 27
dissertationheaven.co.uk	New company 27
pureassignments.com	New company 27
ultimateessays.com	New company 27
assignmentkingdom.co.uk	New company 27
urgentessayhelp.co.uk	New company 27
dissertationkingdom.co.uk	New company 27
groovyessays.co.uk	New company 27
dissertationlounge.co.uk	New company 27
assignmentstar.com	New company 27
customassignmentservices.com	New company 27
customassignmentservice.com	New company 27
proessay.co.uk	New company 27
assignmentland.com	New company 27
essayhelppros.co.uk	New company 27
mightyresearchpapers.com	New company 27
writingspot.co.uk	New company 27
essaydoer.com	New company 27
brilliantassignment.co.uk	New company 27
assignmentshelp.org	New company 27
orderassignments.com	New company 27
proassignment.co.uk	New company 27
assignmentstar.co.uk	New company 27
homeworkclock.com	New company 27
speedyassignment.co.uk	New company 27
correctessays.com	New company 27
australianassignmentshelp.com	New company 27
researchpaperlabs.com	New company 27
assignmentclock.com	New company 27
researchpapergurus.com	New company 27
writecheapessay.com	New company 27
toppaperservice.com	New company 27
topassignmentservice.com	New company 27
assignmenttime.co.uk	New company 27
irishessays.com	New company 27
dissertationhub.co.uk	New company 27
essaychamp.co.uk	New company 27
assignmentglobe.com	New company 27
qualityessay.co.uk	New company 27
getessaypaper.com	New company 27
6dollaressay.com	New company 27
essaytime.co.uk	New company 27
wewriteessay.co.uk	New company 27
writingkingdom.co.uk	New company 27
essayinn.co.uk	New company 27
dissertationlabs.co.uk	New company 27
truedissertationhelp.co.uk	New company 27
assignmenttigers.co.uk	New company 27
essaytrophy.com	New company 27
clickessay.com	New company 27
essaytiger.co.uk	New company 27
essayvalley.co.uk	New company 27
papersarena.com	New company 27
24hwritemyessay.com	New company 27
assignmentsquare.co.uk	New company 27
academicwriting.com.au	New company 28
nursingassignments.com.au	New company 28
essaywritingservice.com.au	New company 28
lifesaveressays.com	New company 29
courseworkwriter.com	New company 29
assignmenthelpuk.com	New company 29
sortmyassignment.com	New company 29
aussieessays.com	New company 29
auassignmenthelp.com	New company 29
canadaessaywriting.com	New company 29
buyessay.co.uk	New company 29
time4paper.com	New company 3
essayclick.net	New company 3
nerdymates.com	New company 3
pro-academic-writers.com	New company 3
writemyessay4me.org	New company 3
essaysheaven.com	New company 3
domyhomework.guru	New company 3
essaynara.com	New company 3
time4papers.com	New company 3
paper-writer.org	New company 3
homeworkhelper.net	New company 3
order-essay-online.net	New company 3
essaydragon.com	New company 3
collegepapers.co.uk	New company 3
time4essay.net	New company 3
writemypaper4me.org	New company 3
essays4u.net	New company 3
onlineessayreview.wordpress.com	New company 3
homework-writer.com	New company 3
college-homework-help.org	New company 3
eduessayhelper.org	New company 3
justbuyessay.com	New company 3
buyresearchpapers.net	New company 3
essaytypers.net	New company 3
pro-homework-help.com	New company 3
buyessayonline.ninja	New company 3
get-essays.net	New company 3
pro-essay-writer.com	New company 3
essayprofs.com	New company 3
essay.coach	New company 3
paperovernight.com	New company 3
majesticpapers.com	New company 3
midnightpapers.com	New company 3
samedaypaper.org	New company 3
dissertationhelplove.co.uk	New company 30
1clickdissertation.co.uk	New company 30
dissertationbox.co.uk	New company 30
quickassignmenthelp.co.uk	New company 30
theessayhelp.co.uk	New company 30
click2dissertation.co.uk	New company 30
doneassignment.co.uk	New company 30
assignmentbox.co.uk	New company 30
essaybox.co.uk	New company 30
bestessayhelp.co.uk	New company 30
click2assignment.co.uk	New company 30
donedissertation.co.uk	New company 30
topassignmenthelp.co.uk	New company 30
fastassignmenthelp.co.uk	New company 30
courseworkbox.co.uk	New company 30
essayyard.co.uk	New company 30
courseworkhome.co.uk	New company 30
fastdissertationhelp.co.uk	New company 30
fullassignmenthelp.co.uk	New company 30
bestassignmenthelp.co.uk	New company 30
maxdissertationhelp.co.uk	New company 30
speedyessay.co.uk	New company 30
essaymills.com	New company 31
buyassignmentonline.com	New company 31
homeworkcrest.com	New company 32
customwritingpros.com	New company 32
studentsassignmenthelp.com	New company 33
singaporeassignmenthelp.com	New company 33
myassignmentservices.com.au	New company 34
myassignmenthelpoz.com	New company 34
essaybox.org	New company 35
buycollegeessays.org	New company 35
ozassignments.com	New company 36
locusassignments.com	New company 36
essaysmaster.com	New company 37
essaywritersworld.com	New company 37
customthesis.org	New company 37
essayexpert.us	New company 37
essayssos.com	New company 37
academiccoursework.co.uk	New company 37
best-uk-dissertation.com	New company 37
essayscampus.com	New company 37
buy-custom-essays-online.com	New company 37
essaywriting-servicereviews.com	New company 37
perfectwriting.co.uk	New company 38
perfectdissertation.co.uk	New company 38
perfectwriter.co.uk	New company 38
hireresearcher.com	New company 38
writersupport.co.uk	New company 38
customwriter.co.uk	New company 38
exclusivewriter.co.uk	New company 38
perfectassignment.co.uk	New company 38
gopaperwriter.com	New company 38
writershelp.co.uk	New company 38
assignmentwriter.co.uk	New company 38
onlinewriter.co.uk	New company 38
assignmentservice.co.uk	New company 38
dissertationonline.co.uk	New company 38
paperwriters.co.uk	New company 38
getwriterhelp.co.uk	New company 38
freeassignmenthelp.com	New company 39
onlineassignmenthelp.com.au	New company 39
traditionessaysonline.com	New company 4
essaycaptains.com	New company 4
essayscouncil.com	New company 4
essaypaperreviews.com	New company 4
dissertationcouncil.co.uk	New company 4
reviewsofessaycompanies.com	New company 4
writeversity.com	New company 4
dissertationcapital.com	New company 4
rospher.com	New company 4
higherscorestestprep.com	New company 4
essayacademia.com	New company 4
american-writers.org	New company 4
clazwriters.com	New company 4
customedwriting.com	New company 4
mightyessays.com	New company 4
reviews.clazwork.com	New company 4
buyessays.us	New company 4
essayservices.org	New company 4
bestessaywritingservice.co	New company 4
laustan.com	New company 4
rehabilitationspecialists.com.au	New company 4
triumphessays.com	New company 4
essayguardian.com	New company 4
liftedlogic.com	New company 4
essayjaguar.com	New company 4
usawriters.org	New company 4
essayreviewratings.com	New company 4
thecreativepenn.com	New company 4
clazwork.com	New company 4
evolution-coaching.com	New company 4
assignmentsbox.co.uk	New company 40
dissertationservices.co.uk	New company 40
dissertationserviceuk.com	New company 40
regentediting.co.za	New company 40
redmarkediting.com	New company 40
regentediting.co.uk	New company 40
customwritingbay.com	New company 41
researchwritinghelp.com	New company 41
thesis-dissertationwritingservices.com	New company 41
customwritingbay.ca	New company 41
assignmentclub.co.uk	New company 42
academicwritersbureau.com	New company 42
nursingwritingservices.com	New company 42
bestessaysexperts.com	New company 42
managementwritingsolutions.com	New company 43
managementpaper.com	New company 43
penmypaper.com	New company 43
urgenthomework.com	New company 44
myassignmenthelp.net	New company 44
globalassignmenthelp.com	New company 45
dissertationfirst.co.uk	New company 45
assignmentdesk.co.uk	New company 45
instantassignmenthelp.com.au	New company 45
ausassignmenthelp.com	New company 45
instantassignmenthelp.com	New company 45
assignmentprime.com	New company 45
instantessaywriting.com	New company 45
onlinedissertationwriting.co.uk	New company 45
globalassignmenthelp.com.au	New company 45
academicwritingexperts.com	New company 46
britishessaywriters.co.uk	New company 46
britishessayshelp.co.uk	New company 46
britishcourseworkhelp.co.uk	New company 46
britishessaywriting.co.uk	New company 46
britishassignmentwriters.co.uk	New company 46
essayswritingservice.co.uk	New company 46
ukessaysexperts.co.uk	New company 46
ukassignmentshelp.co.uk	New company 46
britishdissertationshelp.co.uk	New company 46
britishassignmentshelp.co.uk	New company 46
ukwritingexperts.co.uk	New company 46
phddissertation.co.uk	New company 46
britishcustomessay.co.uk	New company 46
papermatic.co.uk	New company 46
lawessayshelp.co.uk	New company 46
ukessaywriters.co.uk	New company 46
writemycustomessay.co.uk	New company 46
britishdissertationwriters.co.uk	New company 46
assignmenthelponweb.co.uk	New company 46
britishessaywritingservice.co.uk	New company 46
courseworksquare.co.uk	New company 46
essaywritinglibrary.co.uk	New company 46
lawessaywriters.co.uk	New company 46
doneessays.co.uk	New company 46
abcessays.co.uk	New company 46
buyonlineessay.co.uk	New company 46
dissertationpros.co.uk	New company 46
ukessaytigers.co.uk	New company 46
britishassignmentwriting.co.uk	New company 46
smartessaywriters.co.uk	New company 46
customessayswriter.co.uk	New company 46
lawessayteacher.co.uk	New company 46
essaystigers.co.uk	New company 46
ukacademicwriters.co.uk	New company 46
essaysonweb.co.uk	New company 46
assignmentsonweb.co.uk	New company 46
professionalessaywriters.co.uk	New company 46
orderessaywriting.com	New company 47
bestcustomwriting.com	New company 47
waywriting.com	New company 47
wiseessays.com	New company 47
assignmenthelpnow.com.au	New company 49
assignmenthelps.com.au	New company 49
assignmentfirm.com	New company 49
essaybureau.com	New company 5
essaykitchen.net	New company 5
essaybasics.com	New company 5
premierwritings.com	New company 5
essayagents.com	New company 5
superioressaywriters.com	New company 5
cheapcustomwriting.com	New company 5
tutorversal.com	New company 5
professionalacademicwriters.com	New company 5
customwritingtips.com	New company 5
mintessays.com	New company 5
researchmasteressays.com	New company 5
questwriters.org	New company 5
perfectessay.com	New company 5
academicessaywriters.com	New company 5
uk-essays.co.uk	New company 5
allwritingexperts.com	New company 5
researchpapers247.com	New company 5
customessayorder.com	New company 5
quickessaywriters.co.uk	New company 5
uk-customessays.co.uk	New company 5
preeminentessaywriters.com	New company 5
guruwritings.com	New company 5
giantessays.com	New company 5
myassignmentservices.co.uk	New company 5
currentessay.com	New company 5
lastminuteassignmenthelp.com	New company 5
writemyessaybay.com	New company 5
researchpapersforsale.org	New company 5
myassignmentservices.com	New company 5
custom-essaywritings.com	New company 5
writemyessay.ca	New company 5
custom-essay.ca	New company 5
homeworkhelpglobal.com	New company 50
topqualityassignment.com	New company 51
assignmentwriting.co.uk	New company 51
topassignmentprovider.com	New company 51
kingessay.co.uk	New company 52
mhrwriter.co.uk	New company 52
myassignmenthelp-aus.com	New company 52
allassignmenthelp.com.au	New company 53
allassignmenthelp.com	New company 53
allhomeworkhelp.co.uk	New company 53
allassignmenthelp.co.uk	New company 53
makemyassignments.co.uk	New company 53
essaywritingserviceuk.co.uk	New company 54
academicsciences.co.uk	New company 54
help4assignment.co.uk	New company 55
prodissertation.co.uk	New company 55
australia.writemyessay.biz	New company 56
cheapwritingservices.net	New company 56
writemythesis.net	New company 56
writemydissertation.net	New company 56
ireland.thesiswritingservice.com	New company 56
professionalletterwriting.net	New company 56
programmingassignment.net	New company 56
resumeeditingservice.com	New company 56
ireland.writemyessay.biz	New company 56
malaysia.thesiswritingservice.com	New company 56
buyessaysonline.org	New company 56
phdthesiswriting.biz	New company 56
phdthesisonline.com	New company 56
essaysforsale.net	New company 56
australia.thesiswritingservice.com	New company 56
canada.thesiswritingservice.com	New company 56
australia.customessaywritingservices.com	New company 56
cheapresumewritingservices.net	New company 56
courseworkhelp.org	New company 56
cheapessaywritingservices.com	New company 56
customresearchpapers.biz	New company 56
canada.customessaywritingservices.com	New company 56
phddissertation.info	New company 56
professionaldissertationwriters.com	New company 56
psydissertation.com	New company 56
scriptwriting.biz	New company 56
ireland.customessaywritingservices.com	New company 56
customessaywritingservices.com	New company 56
phdresearch.net	New company 56
professionalessaywriters.com	New company 56
singapore.thesiswritingservice.com	New company 56
buycustomessays.net	New company 56
financehomeworkhelp.org	New company 56
writemyessay.biz	New company 56
bestpaperwriters.net	New company 57
24x7assignmenthelp.com	New company 58
universityhomeworkhelp.com	New company 58
assignmentsweb.com	New company 58
myhomeworkhelp.com	New company 58
mypaperhub.com	New company 59
mypaperpros.net	New company 59
mypapergeek.net	New company 59
mypaperpros.com	New company 59
assignmentessayhelp.com	New company 60
expertassignmenthelp.com	New company 60
premiumpapers.net	New company 61
myessayservices.com	New company 61
primepapers.net	New company 61
essay-write.net	New company 61
order-papers.com	New company 61
ozassignmenthelp.com.au	New company 62
assignmenthelpsite.com	New company 62
hndassignments.co.uk	New company 62
courseworkwriters.co.uk	New company 64
essayshelf.com	New company 64
dissertationplanet.co.uk	New company 64
aussiewritingservice.com	New company 64
yourperfectenglish.com	New company 65
proofreading.org	New company 65
qualityproofreading.co.uk	New company 65
cheap-dissertation-writing.co.uk	New company 66
dissertationwritingmasters.co.uk	New company 66
theacademicpapers.co.uk	New company 66
cheap-essay-writing.co.uk	New company 66
affordable-dissertation.co.uk	New company 66
projectsdeal.co.uk	New company 67
projectsdeal.com	New company 67
assignmentglory.co.uk	New company 68
essayleaks.co.uk	New company 68
essayleaks.com	New company 68
essayarsenal.co.uk	New company 68
essaygator.com	New company 7
myassignmenthelp.com	New company 7
topassignmentreviews.com	New company 7
myassignmenthelp.info	New company 7
myassignmenthelp.co	New company 7
myassignmenthelp.co.uk	New company 7
myassignmenthelp.mobi	New company 7
ukacademia.co.uk	New company 9
paperprovider-aus.com	New company 9
topqualityessays-aus.com	New company 9
assignmenthelp-aus.com	New company 9
essayproviders.co.uk	New company 9
theassignmenthelp.co.uk	New company 9
assignmentprovider.co.uk	New company 9
assignmentprovider-aus.com	New company 9
assignmentwritinguk.co.uk	New company 9
topqualityessays.com	New company 9
cvcentre.co.za	New*cvcenter
theresumecenter.com	New*cvcenter
cvcenter.fr	New*cvcenter
resumecentre.ca	New*cvcenter
resumecentre.com.au	New*cvcenter
cvcentre.co.uk	New*cvcenter
melbourneresumes.com.au	New*melbourneresumes
powerresumes.com.au	New*melbourneresumes
purplecv.co.uk	New*purplecv
cv1services.com	New*purplecv
resumeprofessionalwriters.com	New*resumeprofessionalwriters
chapmanservices.com	New*resumeprofessionalwriters
acclaimedresumes.com	New*resumeprofessionalwriters
resumewriters.com	New*resumeprofessionalwriters
resumeprime.com	New*resumeprofessionalwriters
resumesguaranteed.com	New*resumeprofessionalwriters
best10resumewriters.com	New*resumeprofessionalwriters
capstoneresumes.com	New*resumeprofessionalwriters
resumetarget.ca	New*resumetarget
resumetarget.com	New*resumetarget
successfulcv.co.uk	New*successfulresume
successfulresume.com.au	New*successfulresume
successfulresumes.co.nz	New*successfulresume
trustpilot.com	other
bestreviewer.com.au	other
au.trustpilot.com	other
overleaf.com	other
top5reviewed.com	other
pennlawreview.com	other
americanbookreview.org	other
cnet.com	other
griffithreview.com	other
papersapp.com	other
toptenreviews.com	other
pfjobs.co.uk	other
pages.ebay.com	other
mumsnet.com	other
order.postmates.com	Other
uk.trustpilot.com	other
thewritepractice.com	Other
collegepaperbuddy.com	Other
freeindex.co.uk	other
yellowpages.ca	other
oxbridgeessays.com	Oxbridgeessays
oxfordediting.com	Oxfordediting
academicpapergenius.com	Papermoz
papersdom.co.uk	Papermoz
dissertationplace.co.uk	Papermoz
paperwin.co.uk	Papermoz
assignmentmentors.com	Papermoz
essaymart.co.uk	Papermoz
paperwin.com	Papermoz
myessayexperts.com	Papermoz
dissertationplace.com	Papermoz
theassignments.co.uk	Papermoz
writinghelp.co.uk	Papermoz
papersdom.com	Papermoz
profninja.com	Papermoz
writingjunction.com	Papermoz
professay.com	Professay
easygoessay.com	Professay
top5resumewriters.com	Resume writing group
resumestoyou.com.au	resumestoyou.com.au
resumeworld.ca	resumeworld.ca
resumewriterdirect.com	resumewriterdirect.com
rynoresumes.com	Ryno resumes
scribendi.com	Scribendi
speedypaper.com	Speedypaper
cheapessaywritings24.com	Speedypaper
papercoach.net	Speedypaper
rocketpaper.net	Speedypaper
waywrite.com	Speedypaper
writecustom.com	Speedypaper
eassignmenthelp.com	Speedypaper
serachandtop.com	Speedypaper
cheapdissertationwriting.com	Speedypaper
standout-cv.com	standout-cv.com
solidessay.com	SwiftPapers
termpaperscorner.com	TermPapersCorner
thecvstore.net	thecvstore.net
thecvwriters.co.uk	Thecvwriters
essayexperts.ca	ThePaperExperts
thepaperexperts.com	ThePaperExperts
theunitutor.com	Theunitutor
topresume.com	topresume.com
resume2hire.com	topresume.com
essayvictory.biz	Trionika
1ws.com	Trionika
writingsguru.com	Trionika
criminaljusticewriters.com	Trionika
essaytoday.net	Trionika
writemyessay24h.net	Trionika
paperswrite.org	Trionika
paperduenow.org	Trionika
payforassignment.net	Trionika
thrivingwriter.com	Trionika
affordablepaper.net	Trionika
do-my-coursework.com	Trionika
handmadewritings.com	Trionika
writemypaper.net	Trionika
yourhomeworkhelp.org	Trionika
buyessaysonline.co.uk	Trionika
writemyessay24h.org	Trionika
cheapestessaywritingservice.org	Trionika
affordablepaper.org	Trionika
breezewriting.com	Trionika
papersduenow.com	Trionika
custompaperswriting.com	Trionika
cheapessaywriter.net	Trionika
uk.essay-writing-place.com	Trionika
masterpapers.org	Trionika
paidforessay.com	Trionika
buyessayfriend.com	Trionika
evolutionwriters.com	Trionika
domyassignment.net	Trionika
advanceessay.com	Trionika
customwritingz.org	Trionika
topessaywriter.org	Trionika
bidforessay.com	Trionika
writers-house.com	Trionika
gmhelp.com	Trionika
write-my-term-paper.com	Trionika
jetwriters.com	Trionika
do-my-term-paper.net	Trionika
essayday.com	Trionika
paper-helper.org	Trionika
life-underwriting.com	Trionika
writemyessaysonline.com	Trionika
write-my-research-paper.com	Trionika
researchpaperonline.net	Trionika
pay-for-essay.biz	Trionika
payforessays.org	Trionika
writemyessaytoday.net	Trionika
writemyessayfast.org	Trionika
fastwritings.com	Trionika
thesaurusessay.com	Trionika
10writers.com	Trionika
write-my-assignment.com	Trionika
academic-writing.org	Trionika
customwritingcompany.com	Trionika
au.essaydune.com	Trionika
myadmissionsessay.com	Trionika
myessay.today	Trionika
essayhawk.com	Trionika
stormessay.org	Trionika
essaydune.com	Trionika
bestessay.website	Trionika
buycollegeessay.org	Trionika
prowriterscenter.com	Trionika
writemyessayapp.com	Trionika
freshessays.com	Trionika
essay.expert	Trionika
jetessay.com	Trionika
hireessaywriter.org	Trionika
writeex.com	Trionika
buyanessay.com	Trionika
essaywriting.center	Trionika
buythesisonline.org	Trionika
pinkelstar.com	Trionika
ca.essaydune.com	Trionika
rush-essays.com	Trionika
write-my-thesis.net	Trionika
orderyouressay.com	Trionika
essay-writing-place.com	Trionika
essaybeats.com	Trionika
coursework4u.co.uk	Trionika
thetermpapers.net	Trionika
essay-writer.club	Trionika
write-my-dissertation.net	Trionika
buzzessay.com	Trionika
besteditingonline.com	Trionika
uk-essay-reviews.com	Trionika
researchpaperwritings.net	Trionika
writeyourpaper.org	Trionika
essayswriting.org	Trionika
paperhelp.org	Trionika
uk.essaydune.com	Trionika
essaywriter.pro	Trionika
essaywritingtips.org	Trionika
essayforcollege.org	Trionika
buyessays.cheap	Trionika
writingsmyessays.com	Trionika
justdomyhomework.com	Trionika
essayboss.org	Trionika
writemyessays.net	Trionika
essayhunter.co.uk	Trionika
affordable-papers.net	Trionika
essayskills.com	Trionika
online-essay-service.com	Trionika
customwritingz.net	Trionika
essay-writing-tips.com	Trionika
911essayhelp.com	Trionika
college-writers.com	Trionika
buildupessay.com	Trionika
customwritingcenter.net	Trionika
darwinessay.net	Trionika
pay4homework.com	Trionika
writingbee.us	Trionika
research-paper-writer.net	Trionika
essayagency.com	Trionika
writemypapers.org	Trionika
writemypaperforme.com	Trionika
pimion.com	Trionika
buyanessaysonline.com	Trionika
essaytrust.org	Trionika
freelancehouse.co.uk	Trionika
youressayhelper.com	Trionika
pay4essays.com	Trionika
myadmissionsessay.us	Trionika
essays2buy.org	Trionika
paperwritings.com	Trionika
domyhomework4me.net	Trionika
essaytigers.com	Trionika
dissertationwriter.org	Trionika
paytowriteessay.net	Trionika
writingessayeast.com	Trionika
essayuniverse.org	Trionika
au.essay-writing-place.com	Trionika
acewriters.org	Trionika
writeeessayforme.com	Trionika
writemypaper.co	Trionika
essaygoddess.com	Trionika
cheap-essay.net	Trionika
12hoursessay.com	Trionika
3monkswriting.com	Trionika
research-paper.essayempire.com	Trionika
domydissertation.org	Trionika
expert-editing.org	Trionika
write-my-essay-for-me.org	Trionika
essaywritingtipssite.wordpress.com	Trionika
homeworkhelponline.ca	Trionika
essay-lib.com	Trionika
darwinessays.org	Trionika
dissertationwritings.com	Trionika
fastessayhelp.net	Trionika
writeessayonline.com	Trionika
writepaperforme.org	Trionika
thepaperhelp.org	Trionika
thewritingkid.com	Trionika
jayessay.com	Trionika
paper-help.us	Trionika
papersmaster.com	Trionika
customessayonline.co.uk	Trionika
domyessay.today	Trionika
highschoolessay.com	Trionika
paper-help.me	Trionika
paper-due-now.com	Trionika
help-with-homework.com	Trionika
buyessayhelp.net	Trionika
essays.agency	Trionika
customessays.me.uk	Trionika
essaystyle.com	Trionika
professionalresumesolutions.com	Trionika
buyessaysfast.com	Trionika
rushbuyessay.com	Trionika
affordable-paper.com	Trionika
writemyadmissionessay.com	Trionika
write-for-me.com	Trionika
darwinessays.net	Trionika
pay-for-my-essay.com	Trionika
custom-writings.org	Trionika
my-assignment-help.org	Trionika
uk-assignments.com	UK-assignments
dissertation-help.co.uk	Ukdissertation.co.uk
researchpaperspot.com	Ukdissertation.co.uk
dissertationking.co.uk	Ukdissertation.co.uk
usatermpapers.com	Ukdissertation.co.uk
dissertationhomework.com	Ukessays
ukdissertations.com	Ukessays
researchmyassignment.com	Ukessays
ukessays.co.uk	Ukessays
proofreadmyfile.com	Ukessays
ukessays.com	Ukessays
academicknowledge.com	Ukessays
lawteacher.net	Ukessays
ultius.com	Ultius
unemployedprofessors.com	Unemployedprofessors
essayhelp.me	Uvocorp
hq-essay.com	Uvocorp
onlineessay.us	Uvocorp
onlineessayshelper.com	Uvocorp
fleekessays.com	Uvocorp
essayinau.com	Uvocorp
assignments.writepro.net	Uvocorp
buy-an-essay-online.com	Uvocorp
domyessays.com	Uvocorp
writingsservices.com	Uvocorp
essayhave.com	Uvocorp
doessay.net	Uvocorp
essaywritingtime.com	Uvocorp
aupaperwriting.com	Uvocorp
assignment.essayshark.com	Uvocorp
writingtoserve.net	Uvocorp
maxhomework.com	Uvocorp
essayflow.com	Uvocorp
research.writepro.net	Uvocorp
homeworkneeded.com	Uvocorp
dissertationhelp.com	Uvocorp
helpwritingapaper.com	Uvocorp
instantwritings.com	Uvocorp
writtinganessay.com	Uvocorp
5homework.com	Uvocorp
papercheap.co.uk	Uvocorp
kingessays.com	Uvocorp
domywriting.com	Uvocorp
meowessay.com	Uvocorp
writepro.net	Uvocorp
affordablepapers.com	Uvocorp
essayargumentative.com	Uvocorp
pay4writing.com	Uvocorp
advancedwriters.com	Uvocorp
mastersthesiswriting.com	Uvocorp
collegepaperworld.net	Uvocorp
cheapessay.net	Uvocorp
paperchoice.org	Uvocorp
cheapwritinghelp.com	Uvocorp
1custompapers.com	Uvocorp
midterm.us	Uvocorp
collegepaperworld.com	Uvocorp
superbpaper.com	Uvocorp
bestessaycheap.com	Uvocorp
writing-expert.com	Uvocorp
buy-essay-cheap.com	Uvocorp
paperwritinghelp.net	Uvocorp
essay-lab.com	Uvocorp
bid4papers.com	Uvocorp
essaywritingsecret.org	Uvocorp
essay2me.com	Uvocorp
augoodessay.com	Uvocorp
essayoneday.com	Uvocorp
anycustomwriting.com	Uvocorp
essayforme.org	Uvocorp
getessaynow.com	Uvocorp
paperhelpwriting.com	Uvocorp
expertwriting.org	Uvocorp
essayhelp.io	Uvocorp
online-paper-writer.com	Uvocorp
youresearchpaper.com	Uvocorp
greatpaper.co.uk	Uvocorp
power-essays.com	Uvocorp
buyessayscheap.com	Uvocorp
sweettermpapers.com	Uvocorp
writemypaper.io	Uvocorp
domyresearchpaper.com	Uvocorp
domyessay.net	Uvocorp
papersgram.com	Uvocorp
essaydoc.com	Uvocorp
essaybuy.co.uk	Uvocorp
domypapers.com	Uvocorp
paytowritepaper.com	Uvocorp
essayup.com	Uvocorp
cheapresearchpaperforsale.blogspot.com	Uvocorp
buyessaylive.com	Uvocorp
essay-writing-service.net	Uvocorp
thepensters.com	Uvocorp
crazyessay.com	Uvocorp
essayspark.com	Uvocorp
omnipapers.com	Uvocorp
paytowriteessays.com	Uvocorp
pay-for-essay.com	Uvocorp
effectivepapers.com	Uvocorp
papersmart.net	Uvocorp
buyessay.org	Uvocorp
guruwritersinca.com	Uvocorp
ordercheappaper.com	Uvocorp
livepaperhelp.com	Uvocorp
gpalabs.com	Uvocorp
papers4.sale	Uvocorp
writeapaperforme.com	Uvocorp
writing-help.com	Uvocorp
essay4students.com	Uvocorp
coolessay.net	Uvocorp
orderessay.net	Uvocorp
essayviewer.com	Uvocorp
essayhere.com	Uvocorp
essaytwist.com	Uvocorp
smartwritingservice.com	Uvocorp
buyessaycheaper.com	Uvocorp
4students.us	Uvocorp
essaywritinginau.com	Uvocorp
essayshark.com	Uvocorp
customwritings.com	Uvocorp
homeworkgiant.com	Uvocorp
essayscaning.com	Uvocorp
writingpaper.org	Uvocorp
englishresearchpaper.com	Uvocorp
cleverwritings.com	Uvocorp
cheapwritingservice.com	Uvocorp
essayltd.com	Uvocorp
essayhelp.org	Uvocorp
domyassignments.com	Uvocorp
cheapessayservice.org	Uvocorp
idoessay.com	Uvocorp
emergencyessay.com	Uvocorp
doanassignment.com	Uvocorp
hiringwriter.com	Uvocorp
onlinecollegeessay.com	Uvocorp
buyessayclub.com	Uvocorp
writecustomessays.com	Uvocorp
essayerudite.com	Uvocorp
writemypaperhub.com	Uvocorp
essaybuy.org	Uvocorp
writingcities.net	Uvocorp
customtermpaperwriting.com	Uvocorp
essaygoal.com	Uvocorp
cheapwritingservice.org	Uvocorp
essays24.org	Uvocorp
thesiskeeper.com	Uvocorp
customwritingservice.com	Uvocorp
helpessayonline.com	Uvocorp
senperfect.com	Uvocorp
bestwebsite4essays.com	Uvocorp
writemyessayonline.com	Uvocorp
buy2essays.com	Uvocorp
joinpaper.com	Uvocorp
domycoursework.com	Uvocorp
mcessay.com	Uvocorp
paperstime.com	Uvocorp
wedohomework.net	Uvocorp
writingcheap.com	Uvocorp
coursework.writepro.net	Uvocorp
paper4college.com	Uvocorp
fullofbeansessaywriters.com	Uvocorp
buyphdnow.com	Uvocorp
writingdone.com	Uvocorp
termpaperforyou.com	Uvocorp
cosmoessay.com	Uvocorp
paperwritingonline.com	Uvocorp
writeanypapers.com	Uvocorp
cheapessaysonline.com	Uvocorp
thesishelp.net	Uvocorp
idoassignment.com	Uvocorp
essayforyou.com	Uvocorp
smartessay.org	Uvocorp
writemyessaysclub.com	Uvocorp
essaylib.com	Uvocorp
essaylook.com	Uvocorp
essaypay.com	Uvocorp
prowritingservice.com	Uvocorp
writemypapers4me.com	Uvocorp
essayhelp4me.com	Uvocorp
worldessays.com	Uvocorp
writercheap.com	Uvocorp
writer4sale.com	Uvocorp
writingpaperonline.com	Uvocorp
essay-writing-service.biz	Uvocorp
buyessay4me.com	Uvocorp
buywritingpaper.com	Uvocorp
helphomework.net	Uvocorp
rapidessay.com	Uvocorp
bookwormhub.com	Uvocorp
whataboutessay.com	Uvocorp
doahomework.com	Uvocorp
analyze.academichelp.net	Uvocorp
assignmentwriters247.com	Uvocorp
write4essay.com	Uvocorp
cooldissertation.com	Uvocorp
writemytermpapers.com	Uvocorp
essaypro.net	Uvocorp
fastessay.com	Uvocorp
buydissertations.com	Uvocorp
essayseek.com	Uvocorp
uk.customwritings.com	Uvocorp
en.wikipedia.org	Wiki
writeincolor.com	Writeincolor
writersperhour.com	Writersperhour
customessay.com	Customessay